11,10
3,4,5,0,0,0,0,0,0,0,0
3,3,41,0,0,0,0,0,0,0,0
3,3,10,0,0,0,0,0,0,0,0
91,90,100,0,0,0,0,0,0,0,0
0,0,0,0,0,0,0,0,0,0,0
0,0,0,0,0,0,0,0,1,2,1
0,0,0,0,0,0,0,0,0,0,0
0,0,0,0,0,0,0,0,0,0,0
1,1,1,1,1,1,1,1,1,1,1
1,1,1,1,1,1,1,1,1,1,1